11111111111111111111111
10000000000000000000001
100000000C000C000000001
10000000000000000000001
10000000000000000000001
10000000000000E00000001
10000C00000000000000001
11111000000000000000001
100P1000000000000000001
10000000000000000000001
11111111111111111111111
