11111111111111111111
10000000000000000001
1000C000000000000001
10000000000P00000001
100000000E0000C00001
10000000000111111111
1000C000000000000001
11111111111111111111
