11111111111111111111111
10000000000000000000001
100000000C100C000000001
11111111111000000000001
10000000000000000000001
10C00011111111111111111
10000010000000000000001
11111010000000000E00001
100P1010000000000000001
10000000000000000000001
11111111111111111111111
