11111111111111111111
10000000000000000001
10000000000000000001
10000000000000000001
10000000000000000001
1000000000C00000P001
10000000000000000001
10000000000000000001
11111111111111111111
