1111111111111
100000000001
1000C000P0001
10000E000000001
10000000000000001
1111111111111111
