1111111111111111111111111111
1000000000000000000000000001
1000000000000000000000000001
1000000000000000000000000001
1000000000000000000000000001
10000P0000000000000000000001
10000000000C0000000000000001
1000000000000000000000000001
10000000000000C0000000000001
1111111100000000000000000001
1000000100000000000000000001
10000E0100000000000000000001
1111111111111111111111111111
